111111111
111PEC111
111000111
111111111