111111111
110PEC011
110000011
111111111