1111111111111111111111111
1C1C1C1C1C1C1C1C1C1C1C1E1
1000000000000000000000101
1011111111111111111110001
101C1C1C1C1C1C1C1C1C10111
101C1C1C1C1C1C1C1C1C10011
1C00000000000000C000110P1
1111111111111111111111111
1111111111111111111111111
1100110011110000000011111
1100110011100111100011111
1100110011001111000111111
1100000011000000001111111
1111110011111100011111111
1111110011111000000000111
1111110011111000000000111
1111111111111111111111111