1111111111111111111
11000C00C000C00CC11
1C011CC10100000CC11
11011CC101101111111
11001CC101CC1C00C11
11101CC101111011011
1P001CC1000000010E1
1111111111111111111
