11111111111111111111111111111111111111111
10C00000000000000000000000000000000000001
10111111111000000000000000000000000000001
1000CCC0001000000000000000000000000000001
10000000001111111111100000000000000000001
10000000000000000000100000000000000000001
10111111110000000000100000000000000000001
10000000010000000000100000000000000000001
10000000010111111111100000000000000000001
10000000000000P00000000000CCCCCCC00000001
10000000011111011111111111111110000000001
10000000010000010000000000000100000000001
10000000010000010000000000000100000000001
10000000011111111111111000000111111111101
100000000000000000000010CCCCCCCCCC0000001
10000000000000000000001111111110011000001
1000000000000000000000000000000001000C001
111111111111111111111100000000000100000C1
10C00000000000000000000000000000011111111
10000000000000000000000000000000000000001
1000C000000000000000000000000000000000001
100000000000000000000000000C000000000E001
10000000000000000000000000000000000000001
11111111111111111111111111111111111111111
